NO ../texture/tech/teck1.xpm
SO ../texture/tech/teck2.xpm
WE ../texture/tech/teck3.xpm
EA ../texture/tech/teck5.xpm


F 111,111,111
C 00,000,0

111111111111111
1P00P00000W0001
1000011111D111111111111111
10000110000000000000100011
10000010P0000000P0000D0001
1000P011000000000000010001
111D1111111D11111111110001
110000110000001      10001
100000010000001      10001
100000010000001      10001
1000000D000000111111111D11111111111
10000001000000100000000000000000001
1P00P0010000001000000000000000000011111
110000110000001001100000000000110010001
111111111111111001000000000000010010001
              1000000000000000000010001
              1000000000000000000010001
              1000000000000P000000D0001
              100000000P000000000010001
              1000000000000000000010001
              10010000P00P0000010010001
              1001100P00000P00110010001
              100000000P000000000010001
              100000000P000000000010001
              1111111111111111111110001
                                  10001
                               11110001111
                               10000000001
   1111111111111               10000P00001
   100000000P001               10000000001
   10000P0000001               10000000001
   10000P0000001               10000000001
   100000000P001               10100P00101
   1000000000001               10000000001
   10011111111111111111111     11111D11111
   100D0000000000000000001       100001
   11110000000000000000001       100001
      100000P0000000000001       100001
  11111000000000000111D1111111111100001
  1000D00000P0000001P000000000000000001
  1000100000P00000010000000000000000001
  1000100000000000010000000000000000001
  1000111111D11111110000000000000000P01
  1000000010001    111D1111111111111111
  10000000D0001    100000000001
  1000000010001    100000000001
  1111D11110001    10000P000001
    10001 10101    100000000001
    10001110111    10000P000001
    10000D00001    100000000001
    11111100001    111111D11111
         110001        10001
          10001        10001
           10001       10101
            10001      11111
             10001
              10001
               10001
                10001111111111111111111111111111111111111
                10000010001000001000000010000000001010001
                11101010101011101011101110111011101011101
                10001000101010101000100000101010000000001
                10101110111110101111111010101110111111111
                10101010100000P000100000101P0010100010001
                10111011111111111010111110101111111010101
                10101010001000001010000010000010100000101
                10101010101110111011101011111110111111101
                10000010101000001000001010100010001000001
                10101010111111101110111110101111101011101
                10101000000010000010000000000010000000101
                11101010111110111010101011101110111111111
                10101010P000001000001010001P0000100000001
                10101110111010111010101111111110101111101
                1000100000101000101010100000001000001011
                10111011101110101011111011101110111010101
                10100010001010101000001000100010001010101
                10111010101011101111101011101111101010101
                10100010101000101000100000100010101010001
                10111010101110101110101011111110111011101
                10101010100000101000001000100010001010101
                10101110101111111110101111101110101010101
                10001000100010000000100010000010101010101
                10101011101010101111111110111110111010111
                10101010001010100000000000100000100010001
                101010111110111111111111101011111111111011
                10101000101000001000001000101000001000001
                11101110101111111010111110101010111011111
                10001000000010000010100010000010100000001
                10111111111011101010101111111110111111101
                10100000001000001010000010000010001010001
                11101010111110111011111010111111101010101
                1000101010000010000000101010P000100010101
                10101110101011101111101110101110111010111
                10101000101010000010000010001000000010001
                10101011101010111011111111111010111010101
                10101000001010101000000000001010001000101
                101011111110101010111011111010111011111D111111111
                1010000010001000101000000010101000000010000000001
                1111111111111111111111111111111111111111100000001
                                                        1PPPPPPP1
                                                        1PPPPP0P1
                                                        1PPPPPPP1
                                                        1PPPPPPP1
                                                        111111111
